,Fall,College,Major Name,Total,Male,Female
280,1981,Education,Elementary Education,432,27,405
279,1981,Education,Educational Psychology,148,69,79
273,1981,Education,EDUC ELEMENTARY,141,23,118
277,1981,Education,Ed Organization and Leadership,129,57,72
281,1981,Education,Special Education,128,18,110
278,1981,Education,Educ Voc Tech,115,54,61
274,1981,Education,EDUC GEN,113,21,92
272,1981,Education,ED SEC&CON,110,40,70
287,1981,Education,TECH ED SP,67,46,21
271,1981,Education,ED POL ST,63,35,28
