,Fall,College,Major Name,Total,Male,Female
4259,2001,Business,Business Administration,1428,811,617
4264,2001,Business,Finance,1026,668,358
4258,2001,Business,Accountancy,1001,487,514
4270,2001,Business,UNASSIGNED,518,286,232
4261,2001,Business,Computer Science,437,361,76
4262,2001,Business,Economics,252,162,90
4269,2001,Business,Theatre,97,47,50
4268,2001,Business,Technical Systems Management,86,80,6
4263,2001,Business,Executive MBA Program,64,45,19
4260,2001,Business,CBA NON-DEGREE,54,32,22
